######################################
#.##.#.###############################
###..###..############################
##........#########################.##
#...@..#..####......................##
#.#..###..####.##.####################
#.#..#....####.##.#...#....#...#...#.#
#.#.##.#.#####.##.####################
#.......###.##.##.#..................#
#......####.##.##.####################
###.##.####.##.##.............########
###.##.###...#.##############...######
###..#.#####.#.####.#.#.#.#.###.######
###..###..##...##############...######
##........###################.########
#......#..####.......................#
###..###..##.............###.........#
##...#....##.#.#.#######..#...###....#
##.##.#.###..###..#.........#.....#..#
#......####...###....................#
#............#########################
######################################