...########
..##...#..####
.##....###...#
##...........#
##...........#
#...@....#...#
###....###...#
..#...#......#
.##..##..#..##
.#.......####
.#......##
.########