######################################
#.##.#.##--##-#####-#--#########-#####
###..#-#..######-########-############
##........##########-#########-####.##
#...@..#..####......................##
#.#..###..#-##.##.####################
#.#..#....##-#.##.#...#....#...#...#.#
#-#.##.#.#####.##.####################
#.......###*##.##.#..................#
#......####.##.##.####################
#-#.##.####.##.##.............########
###.##.###...#.##############...######
#-#..#.#####.#.####.#.#.#.#.###.######
####..###..#....#############...######
#-........#######-###-#######.########
#......#..#-##.......................#
###..###..##.............#-#.........#
##...#....##.#.#.####-##.###..###....#
##.##.#.###..###..#.........#.....#..#
#......####...###....................#
#............#########-######-########
######################################